1111111
1000001
1000001
1000001
10000N1
1111111
