NO ./path_to_the_north_texture
SO ./path_to_the_south_texture
WE ./path_to_the_west_texture
EA ./path_to_the_east_texture

F 222,100,0
C 225,30,0

				1111111111 111111111111111			
				10000000001 10000000000001		
				10110000011 10000000000001
				10010000001 10000000000001		
111111111011000001110000000000001
100000000011000001110111111111111
1111011111111101110E000010001
11110111111111011101010010001
11000000110101011100000010001
10000000000000001100000010001
10000000100000011101010010001
110000011101011 111110111100111
111101111111101 101111010001
11111111111 1111111111111111