NO ./textures/9atila.png
SO ./textures/bkay.png
WE ./textures/cameron.png
EA ./textures/hadaf.png

F 220,100,0
C 225,30,0

1111111111111111111111111
1000000000110000000000001
1011000001110010000000001
10111000000000010000N0000111111111
101111111011000001110000000000001
100000000011000001110111111111111
11110111111111011100000000001
11110111111111010001010101001
11000000110101010100000000001
10000000000000000100000000001
10000000000100001101000010001
1100000111110101111010110001
11110111 1110101 11111010001
11111111 1111111 111111111111
